123 123 123 123 123 123 123 123 123 123 123 123 123 123 123 123 123 123 123 123 123 123 123 123 123 123 123 123 123 123 123 123 123 123 123 123 123 123 123 123 123 123 123 123 123 123 123 123 123 123
123 123 123 123 123 123 123 123 123 123 123 123 123 123 123 123 123 123 123 123 123 123 123 123 123 123 123 123 123 123 123 123 123 123 123 123 123 123 123 123 123 123 123 123 123 123 123 123 123 123
123 123 123 123 123 123 123 123 123 123 123 123 123 123 123 123 123 123 123 123 123 123 123 123 123 123 123 123 123 123 123 123 123 123 123 123 123 123 123 123 123 123 123 123 123 123 123 123 123 123
123 123 123 123 123 123 123 123 123 123 123 123 123 123 123 123 123 123 123 123 123 123 123 123 123 123 123 123 123 123 123 123 123 123 123 123 123 123 123 123 123 123 123 123 123 123 123 123 123 123
123 123 123 123 123 123 123 123 123 123 123 123 123 123 123 123 123 123 123 123 123 123 123 123 123 123 123 123 123 123 123 123 123 123 123 123 123 123 123 123 123 123 123 123 123 123 123 123 123 123
123 123 123 123 123 101 101 101 101 101 101 101 101 101 101 101 101 101 101 101 101 101 101 101 101 101 101 101 112 112 112 112 112 112 112 112 112 112 112 112 112 112 112 112 112 123 123 123 123 123
123 123 123 123 123 101 113 113 101 101 101 101 101 101 101 101 101 101 101 101 101 101 101 101 101 113 113 101 111 111 111 111 111 111 111 111 111 111 111 111 111 111 111 111 111 123 123 123 123 123
123 123 123 123 123 101 113 113 101 114 114 114 114 101 114 114 114 114 114 101 114 114 114 114 101 113 113 101 111 111 111 111 111 111 111 111 111 111 111 111 111 111 111 111 111 123 123 123 123 123
123 123 123 123 123 101 113 113 101 114 115 116 114 101 114 115 119 116 114 101 114 115 116 114 101 113 113 101 111 111 117 111 111 111 117 111 111 111 117 111 111 111 117 111 111 123 123 123 123 123
123 123 123 123 123 101 113 113 101 114 115 116 114 101 114 115 119 116 114 101 114 115 116 114 101 113 113 101 111 111 111 111 111 111 111 111 111 111 111 111 111 111 111 111 111 123 123 123 123 123
123 123 123 123 123 101 101 101 101 114 115 116 114 101 114 115 119 116 114 101 114 115 116 114 101 101 101 101 110 110 110 110 110 110 110 110 110 110 110 110 110 110 110 110 110 123 123 123 123 123
123 123 123 123 123 106 106 106 106 102 102 102 102 106 102 102 102 102 102 106 102 102 102 102 106 106 106 106 102 102 102 102 102 102 102 102 102 102 102 102 102 102 102 102 102 123 123 123 123 123
123 123 123 123 123 102 102 102 102 102 102 102 102 102 102 102 102 102 102 102 102 102 102 102 102 102 102 102 102 102 102 102 102 102 102 102 102 102 102 102 102 102 102 102 102 123 123 123 123 123
123 123 123 123 123 102 102 102 102 102 102 102 102 102 102 102 102 102 102 102 102 102 102 102 102 102 102 102 102 102 102 102 102 102 102 102 102 102 102 102 102 102 102 102 102 123 123 123 123 123
123 123 123 123 123 102 102 102 102 102 102 102 102 102 102 102 102 102 102 102 102 102 102 102 102 102 102 102 102 102 102 102 102 102 102 102 102 102 102 102 102 102 102 102 102 123 123 123 123 123
123 123 123 123 123 102 102 102 102 102 102 102 102 102 102 102 102 102 102 102 102 102 102 102 102 102 102 102 102 102 102 102 102 102 102 102 102 102 102 102 102 102 102 102 102 123 123 123 123 123
123 123 123 123 123 102 102 102 102 102 102 102 102 102 102 102 102 102 102 102 102 102 102 102 102 102 102 102 102 102 102 102 102 102 102 102 102 102 102 102 102 102 102 102 102 123 123 123 123 123
123 123 123 123 123 104 104 104 104 104 104 104 104 104 104 104 104 104 104 104 104 104 104 104 104 104 104 104 104 104 104 104 104 104 104 104 104 104 104 104 104 104 104 104 104 123 123 123 123 123
123 123 123 123 123 103 103 103 103 103 103 103 103 103 103 103 103 103 103 103 103 103 103 103 103 103 103 103 109 119 119 119 119 109 108 108 108 108 108 108 108 108 108 108 108 123 123 123 123 123
123 123 123 123 123 105 105 105 105 105 105 105 105 105 105 105 105 105 105 105 105 105 105 105 105 105 105 105 109 119 119 119 119 109 108 108 108 108 108 108 108 108 108 108 108 123 123 123 123 123
123 123 123 123 123 104 104 104 104 104 104 104 104 104 104 104 104 104 104 104 104 104 104 104 104 104 104 104 109 119 119 119 119 109 108 108 108 108 108 108 108 108 108 108 108 123 123 123 123 123
123 123 123 123 123 103 103 103 103 103 103 103 103 103 103 103 103 103 103 103 103 103 103 103 103 103 103 103 109 119 119 119 119 109 108 108 108 108 108 108 108 108 108 108 108 123 123 123 123 123
123 123 123 123 123 105 105 105 105 105 105 105 105 105 105 105 105 105 105 105 105 105 105 105 105 105 105 105 109 119 119 119 119 109 108 108 108 108 108 108 108 108 108 108 108 123 123 123 123 123
123 123 123 123 123 104 104 104 104 104 104 104 104 104 104 104 104 104 104 104 104 104 104 104 104 104 104 104 109 119 119 119 119 109 108 108 108 108 108 108 108 108 108 108 108 123 123 123 123 123
123 123 123 123 123 103 103 103 103 103 103 103 103 103 103 103 103 103 103 103 103 103 103 103 103 103 103 103 109 119 119 119 119 109 104 104 104 104 104 104 104 104 104 104 104 123 123 123 123 123
123 123 123 123 123 100 100 100 100 100 100 100 100 100 100 100 100 100 100 100 100 100 100 100 100 100 100 100 100 100 100 100 100 100 100 100 100 100 100 100 100 100 100 100 100 123 123 123 123 123
123 123 123 123 123 100 100 100 100 100 100 100 100 100 100 100 100 100 100 100 100 100 100 100 100 100 100 100 100 100 100 100 100 100 100 100 100 100 100 100 100 100 100 100 100 123 123 123 123 123
123 123 123 123 123 100 100 100 100 100 100 100 100 100 100 100 100 100 100 100 100 100 100 100 100 100 100 100 100 100 100 100 100 100 100 100 100 100 100 100 100 100 100 100 100 123 123 123 123 123
123 123 123 123 123 100 100 100 100 100 100 100 100 100 100 100 100 100 100 100 100 100 100 100 100 100 100 100 100 100 100 100 100 100 100 100 100 100 100 100 100 100 100 100 100 123 123 123 123 123
123 123 123 123 123 100 100 100 100 100 100 100 100 100 100 100 100 100 100 100 100 100 100 100 100 100 100 100 100 100 100 100 100 100 100 100 100 100 100 100 100 100 100 100 100 123 123 123 123 123
123 123 123 123 123 100 100 100 100 100 100 100 100 100 100 100 100 100 100 100 100 100 100 100 100 100 100 100 100 100 100 100 100 100 100 100 100 100 100 100 100 100 100 100 100 123 123 123 123 123
123 123 123 123 123 100 100 100 100 100 100 100 100 100 100 100 100 100 100 100 100 100 100 100 100 100 100 100 100 100 100 100 100 100 100 100 100 100 100 100 100 100 100 100 100 123 123 123 123 123
123 123 123 123 123 100 100 100 100 100 100 100 100 100 100 100 100 100 100 100 100 100 100 100 100 100 100 100 100 100 100 100 100 100 100 100 100 100 100 100 100 100 100 100 100 123 123 123 123 123
123 123 123 123 123 125 124 125 124 125 124 125 124 125 124 125 124 125 124 125 124 125 124 125 100 100 125 124 125 124 125 124 125 124 125 124 125 124 125 124 125 124 125 124 125 123 123 123 123 123
123 123 123 123 123 124 125 124 125 124 125 124 125 124 125 124 125 124 125 124 125 124 125 124 107 107 124 125 124 125 124 125 124 125 124 125 124 125 124 125 124 125 124 125 124 123 123 123 123 123
123 123 123 123 123 107 107 107 107 107 107 107 107 107 107 107 107 107 107 107 107 107 107 107 107 107 107 107 107 107 107 107 107 107 107 107 107 107 107 107 107 107 107 107 107 123 123 123 123 123
123 123 123 123 123 118 118 118 118 118 118 118 118 118 118 118 118 118 118 118 118 118 118 118 118 118 118 118 118 118 118 118 118 118 118 118 118 118 118 118 118 118 118 118 118 123 123 123 123 123
123 123 123 123 123 119 119 119 119 119 119 119 119 119 119 119 119 119 119 119 119 119 119 119 119 119 119 119 119 119 119 119 119 119 119 119 119 119 119 119 119 119 119 119 119 123 123 123 123 123
123 123 123 123 123 120 120 120 120 120 120 120 120 120 120 120 120 120 120 120 120 120 120 120 120 120 120 120 120 120 120 120 120 120 120 120 120 120 120 120 120 120 120 120 120 123 123 123 123 123
123 123 123 123 123 119 119 119 119 119 119 119 119 119 119 119 119 119 119 119 119 119 119 119 119 119 119 119 119 119 119 119 119 119 119 119 119 119 119 119 119 119 119 119 119 123 123 123 123 123
123 123 123 123 123 121 121 121 121 121 121 121 121 121 121 121 121 121 121 121 121 121 121 121 121 121 121 121 121 121 121 121 121 121 121 121 121 121 121 121 121 121 121 121 121 123 123 123 123 123
123 123 123 123 123 119 119 119 119 119 119 119 119 119 119 119 119 119 119 119 119 119 119 119 119 119 119 119 119 119 119 119 119 119 119 119 119 119 119 119 119 119 119 119 119 123 123 123 123 123
123 123 123 123 123 120 120 120 120 120 120 120 120 120 120 120 120 120 120 120 120 120 120 120 120 120 120 120 120 120 120 120 120 120 120 120 120 120 120 120 120 120 120 120 120 123 123 123 123 123
123 123 123 123 123 119 119 119 119 119 119 119 119 119 119 119 119 119 119 119 119 119 119 119 119 119 119 119 119 119 119 119 119 119 119 119 119 119 119 119 119 119 119 119 119 123 123 123 123 123
123 123 123 123 123 122 122 122 122 122 122 122 122 122 122 122 122 122 122 122 122 122 122 122 122 122 122 122 122 122 122 122 122 122 122 122 122 122 122 122 122 122 122 122 122 123 123 123 123 123
123 123 123 123 123 123 123 123 123 123 123 123 123 123 123 123 123 123 123 123 123 123 123 123 123 123 123 123 123 123 123 123 123 123 123 123 123 123 123 123 123 123 123 123 123 123 123 123 123 123
123 123 123 123 123 123 123 123 123 123 123 123 123 123 123 123 123 123 123 123 123 123 123 123 123 123 123 123 123 123 123 123 123 123 123 123 123 123 123 123 123 123 123 123 123 123 123 123 123 123
123 123 123 123 123 123 123 123 123 123 123 123 123 123 123 123 123 123 123 123 123 123 123 123 123 123 123 123 123 123 123 123 123 123 123 123 123 123 123 123 123 123 123 123 123 123 123 123 123 123
123 123 123 123 123 123 123 123 123 123 123 123 123 123 123 123 123 123 123 123 123 123 123 123 123 123 123 123 123 123 123 123 123 123 123 123 123 123 123 123 123 123 123 123 123 123 123 123 123 123
123 123 123 123 123 123 123 123 123 123 123 123 123 123 123 123 123 123 123 123 123 123 123 123 123 123 123 123 123 123 123 123 123 123 123 123 123 123 123 123 123 123 123 123 123 123 123 123 123 123
