71 71 71 71 71 71 71 71 71 71 71 71 71 71 71 71 71 71 71 71 71 71 71 71 71 71 71 71 71 71 71 71 71 71 71 71 71 71 71 71 71 71 71 71 71 71 71 71 71 71
71 71 71 71 71 71 71 71 71 71 71 71 71 71 71 71 71 71 71 71 71 71 71 71 71 71 71 71 71 71 71 71 71 71 71 71 71 71 71 71 71 71 71 71 71 71 71 71 71 71
71 71 71 71 71 71 71 71 71 71 71 71 71 71 71 71 71 71 71 71 71 71 71 71 71 71 71 71 71 71 71 71 71 71 71 71 71 71 71 71 71 71 71 71 71 71 71 71 71 71
71 71 71 71 71 71 71 71 71 71 71 71 71 71 71 71 71 71 71 71 71 71 71 71 71 71 71 71 71 71 71 71 71 71 71 71 71 71 71 71 71 71 71 71 71 71 71 71 71 71
71 71 71 71 71 71 71 71 71 71 71 71 71 71 71 71 71 71 71 71 71 71 71 71 71 71 71 71 71 71 71 71 71 71 71 71 71 71 71 71 71 71 71 71 71 71 71 71 71 71
71 71 71 71 71 71 71 71 71 71 71 71 71 71 71 71 71 71 71 71 71 71 71 71 71 71 71 71 71 71 71 71 71 71 71 71 71 71 71 71 71 71 71 71 71 71 71 71 71 71
71 71 71 71 71 71 71 71 71 71 71 71 71 71 71 71 71 71 71 71 71 71 71 71 71 71 71 71 71 71 71 71 71 71 71 71 71 71 71 71 71 71 71 71 71 71 71 71 71 71
71 71 71 71 71 71 71 71 71 71 71 71 71 71 71 71 71 71 71 71 71 71 71 71 71 71 71 71 71 71 71 71 71 71 71 71 71 71 71 71 71 71 71 71 71 71 71 71 71 71
71 71 71 71 71 71 71 71 71 71 71 71 71 71 71 71 71 71 71 71 71 71 71 71 71 71 71 71 71 71 71 71 71 71 71 71 71 71 71 71 71 71 71 71 71 71 71 71 71 71
71 71 71 71 71 71 71 71 71 18 18 18 18 18 18 18 18 18 18 18 18 18 18 18 18 18 18 18 18 18 18 18 18 18 18 18 18 18 18 18 18 71 71 71 71 71 71 71 71 71
71 71 71 71 71 71 71 71 71 18 10 10 10 50 48 49 10 10 10 18 10 10 18 72 10 10 30 44 43 42 30 72 10 10 72 10 10 72 10 10 18 71 71 71 71 71 71 71 71 71
71 71 71 71 71 71 71 71 71 18 73 10 10 41 41 41 47 47 10 18 10 10 18 10 10 10 30 41 41 41 30 10 10 10 10 10 10 10 10 10 18 71 71 71 71 71 71 71 71 71
71 71 71 71 71 71 71 71 71 18 10 10 10 10 10 10 10 10 10 18 10 10 18 10 10 10 10 10 10 10 10 10 10 10 10 10 10 10 10 10 18 71 71 71 71 71 71 71 71 71
71 71 71 71 71 71 71 71 71 18 10 10 10 10 10 10 10 10 10 18 10 10 18 10 10 10 10 10 10 10 10 10 10 10 10 10 10 10 10 10 18 71 71 71 71 71 71 71 71 71
71 71 71 71 71 71 71 71 71 18 10 10 10 10 10 10 10 10 10 18 10 10 18 10 10 10 10 10 10 10 10 10 10 10 10 10 10 10 10 10 18 71 71 71 71 71 71 71 71 71
71 71 71 71 71 71 71 71 71 18 10 10 10 10 10 10 10 10 10 18 10 10 18 10 10 10 38 38 38 38 38 10 10 10 32 36 36 36 31 10 18 71 71 71 71 71 71 71 71 71
71 71 71 71 71 71 71 71 71 18 73 10 10 10 10 10 10 10 10 10 10 10 10 10 10 10 38 38 38 38 38 10 10 10 33 35 35 35 34 10 18 71 71 71 71 71 71 71 71 71
71 71 71 71 71 71 71 71 71 18 10 10 10 10 10 10 10 10 10 18 10 10 18 10 10 10 10 10 10 10 10 10 10 10 10 10 10 10 10 10 18 71 71 71 71 71 71 71 71 71
71 71 71 71 71 71 71 71 71 18 10 10 10 45 46 10 45 46 10 18 10 10 18 10 10 10 10 10 10 10 10 10 10 10 37 37 37 37 37 10 18 71 71 71 71 71 71 71 71 71
71 71 71 71 71 71 71 71 71 18 10 10 10 45 46 10 45 46 10 18 10 10 18 10 10 10 10 10 10 10 10 10 10 10 39 39 39 39 39 10 18 71 71 71 71 71 71 71 71 71
71 71 71 71 71 71 71 71 71 18 10 10 10 10 10 10 10 10 10 18 10 10 18 10 10 10 10 10 10 10 10 10 10 10 10 10 10 10 10 10 18 71 71 71 71 71 71 71 71 71
71 71 71 71 71 71 71 71 71 18 73 10 10 10 10 10 10 10 10 18 10 10 18 10 10 10 10 10 10 10 10 10 10 10 10 10 10 10 10 10 18 71 71 71 71 71 71 71 71 71
71 71 71 71 71 71 71 71 71 18 18 18 18 18 18 18 18 18 18 18 10 10 18 18 18 18 18 10 10 10 18 18 18 18 18 18 18 18 18 18 18 71 71 71 71 71 71 71 71 71
71 71 71 71 71 71 71 71 71 18 10 10 10 10 10 10 10 10 10 10 10 10 10 26 22 22 25 10 10 10 30 30 30 30 30 30 30 30 30 30 18 71 71 71 71 71 71 71 71 71
71 71 71 71 71 71 71 71 71 18 10 10 10 10 10 10 10 10 10 10 10 10 10 23 29 29 21 19 19 19 19 19 19 19 19 19 19 19 19 19 18 71 71 71 71 71 71 71 71 71
71 71 71 71 71 71 71 71 71 18 10 10 10 10 10 10 10 10 10 10 10 10 10 23 29 29 21 20 20 20 20 20 20 20 20 20 20 20 20 20 18 71 71 71 71 71 71 71 71 71
71 71 71 71 71 71 71 71 71 18 10 10 10 10 10 10 10 10 10 10 10 10 10 27 24 24 28 10 10 10 30 30 30 30 30 30 30 30 30 30 18 71 71 71 71 71 71 71 71 71
71 71 71 71 71 71 71 71 71 18 40 40 40 40 40 40 40 40 40 40 40 40 40 40 40 40 40 18 10 10 18 18 18 18 18 18 18 18 18 18 18 71 71 71 71 71 71 71 71 71
71 71 71 71 71 71 71 71 71 18 40 40 40 40 40 40 40 40 40 40 40 40 40 40 40 40 40 18 10 10 18 18 18 18 18 18 18 18 18 18 18 71 71 71 71 71 71 71 71 71
71 71 71 71 71 71 71 71 71 18 40 40 40 40 40 40 40 40 40 40 40 40 40 40 40 40 40 18 10 10 18 18 18 18 18 18 18 18 18 18 18 71 71 71 71 71 71 71 71 71
71 71 71 71 71 71 71 71 71 18 74 61 60 60 60 60 60 60 66 60 60 60 60 60 60 62 74 18 10 10 18 18 18 18 18 18 18 18 18 18 18 71 71 71 71 71 71 71 71 71
71 71 71 71 71 71 71 71 71 18 10 59 68 68 68 68 68 68 69 68 68 68 68 68 68 67 10 18 10 10 10 10 10 10 10 10 10 10 10 10 18 71 71 71 71 71 71 71 71 71
71 71 71 71 71 71 71 71 71 18 10 64 58 57 68 68 68 68 69 68 68 68 68 56 58 65 10 18 10 10 10 10 10 10 10 10 10 10 10 10 18 71 71 71 71 71 71 71 71 71
71 71 71 71 71 71 71 71 71 18 10 59 68 69 68 68 68 68 69 68 68 68 68 69 68 67 10 18 18 18 18 18 18 18 18 18 18 18 18 18 18 71 71 71 71 71 71 71 71 71
71 71 71 71 71 71 71 71 71 18 10 59 68 69 68 68 68 68 70 68 68 68 68 69 68 67 10 10 10 10 10 10 10 10 10 10 10 10 10 10 18 71 71 71 71 71 71 71 71 71
71 71 71 71 71 71 71 71 71 18 10 59 68 69 68 68 68 68 69 68 68 68 68 69 68 67 10 10 10 10 10 10 10 10 10 10 10 10 10 10 18 71 71 71 71 71 71 71 71 71
71 71 71 71 71 71 71 71 71 18 10 64 58 55 68 68 68 68 69 68 68 68 68 54 58 65 10 10 10 10 10 10 10 10 10 10 10 10 10 10 18 71 71 71 71 71 71 71 71 71
71 71 71 71 71 71 71 71 71 18 10 59 68 68 68 68 68 68 69 68 68 68 68 68 68 67 10 10 10 10 10 10 10 10 10 10 10 10 10 10 18 71 71 71 71 71 71 71 71 71
71 71 71 71 71 71 71 71 71 18 10 52 51 51 51 51 51 51 63 51 51 51 51 51 51 53 10 10 10 10 10 10 10 10 10 10 10 10 10 10 18 71 71 71 71 71 71 71 71 71
71 71 71 71 71 71 71 71 71 18 74 10 10 10 10 10 10 10 74 10 10 10 10 10 10 10 74 10 10 10 10 10 10 10 10 10 10 10 10 10 18 71 71 71 71 71 71 71 71 71
71 71 71 71 71 71 71 71 71 18 18 18 18 18 18 18 18 18 18 18 18 18 18 18 18 18 18 18 18 18 18 18 18 18 18 18 18 18 18 18 18 71 71 71 71 71 71 71 71 71
71 71 71 71 71 71 71 71 71 71 71 71 71 71 71 71 71 71 71 71 71 71 71 71 71 71 71 71 71 71 71 71 71 71 71 71 71 71 71 71 71 71 71 71 71 71 71 71 71 71
71 71 71 71 71 71 71 71 71 71 71 71 71 71 71 71 71 71 71 71 71 71 71 71 71 71 71 71 71 71 71 71 71 71 71 71 71 71 71 71 71 71 71 71 71 71 71 71 71 71
71 71 71 71 71 71 71 71 71 71 71 71 71 71 71 71 71 71 71 71 71 71 71 71 71 71 71 71 71 71 71 71 71 71 71 71 71 71 71 71 71 71 71 71 71 71 71 71 71 71
71 71 71 71 71 71 71 71 71 71 71 71 71 71 71 71 71 71 71 71 71 71 71 71 71 71 71 71 71 71 71 71 71 71 71 71 71 71 71 71 71 71 71 71 71 71 71 71 71 71
71 71 71 71 71 71 71 71 71 71 71 71 71 71 71 71 71 71 71 71 71 71 71 71 71 71 71 71 71 71 71 71 71 71 71 71 71 71 71 71 71 71 71 71 71 71 71 71 71 71
71 71 71 71 71 71 71 71 71 71 71 71 71 71 71 71 71 71 71 71 71 71 71 71 71 71 71 71 71 71 71 71 71 71 71 71 71 71 71 71 71 71 71 71 71 71 71 71 71 71
71 71 71 71 71 71 71 71 71 71 71 71 71 71 71 71 71 71 71 71 71 71 71 71 71 71 71 71 71 71 71 71 71 71 71 71 71 71 71 71 71 71 71 71 71 71 71 71 71 71
71 71 71 71 71 71 71 71 71 71 71 71 71 71 71 71 71 71 71 71 71 71 71 71 71 71 71 71 71 71 71 71 71 71 71 71 71 71 71 71 71 71 71 71 71 71 71 71 71 71
71 71 71 71 71 71 71 71 71 71 71 71 71 71 71 71 71 71 71 71 71 71 71 71 71 71 71 71 71 71 71 71 71 71 71 71 71 71 71 71 71 71 71 71 71 71 71 71 71 71
